10
12
0000000000
0000000000
0001111000
0001111000
0000010000
0000010000
0000011000
0000001000
0000001000
0000001000
0000001000
0000001000
3 2 barracks
3 1 fort
3 0 city
0 0 tree
0 1 tree
0 0 circle 0