20
20
00000000000000000220
00000000000000002220
00000000000500002220
00000000600410000200
02225000000111400000
22222000001111100001
22200000222111101140
62000030022111100110
00000022002211000050
00011222200000000000
20011122220022002000
22001222222022222200
22200022200030222220
02000000000000022000
00001400011000006000
00011100001000000000
00111110200500000000
00111110220000000000
00411100220000000000
00011400200060000000
0 3 commander 0
0 2 archer 0
0 4 construction 0
1 3 lambo 0
19 16 commander 1
19 17 wizard 1
19 15 construction 1
18 16 normandy 1
